22 12
R R R R R R R R R R R R R R R R R R R R R R
R R R R R R R R R R R R R R R R R R R R R R
R R R R R R R R R R R R R R R R R R R R R R
R R R R R R R R R R ! ! ! ! ` R R R R R R R
R R R R % ! . 5 ! 4 ! 3 ! ! ! R R R R R R R
R R R R R R R R R R R ! ! ! 5 R R R R R R R
R R R R R R R R R R R ! ! 4 ! R R R R R R R
R R R R R R R R R R R ! ! ! ! R R R R R R R
R R R R R R R R R R R R R R R R R R R R R R
R R R R R R R R R R R R R R R R R R R R R R
R R R R R R R R R R R R R R R R R R R R R R
R R R R R R R R R R R R R R R R R R R R R R

R R R R R R R R R R R R R R R R R R R R R R
R R R R R R R R R R R R R R R R R R R R R R
R R R R R R R R R R R R R R R R R R R R R R
R R R R R R R R R R ! ! ! ! ` R R R R R R R
R R R R % ! . 5 ! 4 ! 3 ! ! ! R R R R R R R
R R R R R R R R R R R ! ! ! 5 R R R R R R R
R R R R R R R R R R R ! ! 4 ! R R R R R R R
R R R R R R R R R R R ! ! ! ! R R R R R R R
R R R R R R R R R R R R R R R R R R R R R R
R R R R R R R R R R R R R R R R R R R R R R
R R R R R R R R R R R R R R R R R R R R R R
R R R R R R R R R R R R R R R R R R R R R R