18 10
# # # # # # # # # # # # # # # # : #
# : # # # # 9 # # J # ! ! # K # # #
# ! ! ! ! ! ! : ! ! ! ! ! ! ! ! ! #
# ! ! [ # # ! # ! ! # : ! # J ! ! #
# # ! # ! ! ! # ! a ! # ! ! # ! 9 #
# 9 ! ! ! , ! # ! ! ! ! ! ! # 2 # #
# # ! ! # ! ! ! ! ! # # 9 # # % # #
# # : # # # # # # J # : # # # # # #
# # # # # # # K # # # # # # # # : #
# # # # # # # # # # # # # # # # # #

M M M M M M M M M M M P P M M M M M
M P P P P P P M P P Q ! ! O P P P M
N ! ! ! ! ! ! F ! ! ! ! ! ! ! ! ! L
N ! ! [ I K ! F ! ! I H ! I H ! ! L
M H ! A ! ! ! F ! a ! G ! ! F ! C M
M N ! ! ! , ! G ! ! ! ! ! ! F ! L M
M N ! ! E ! ! ! ! ! C D D D N ! L M
M M D D M D D D D D M M M M M D M M
M M M M M M M M M M M M M M M M M M
M M M M M M M M M M M M M M M M M M