18 10
c c c c c c c c c c c ` ` c c c c c
c ` ` ` ` ` ` c ` ` ` ! ! c ` ` ` c
c ! ! ! ! ! ! c ! ! ! ! ! ! ! ! ! c
c ! ! r c c ! c ! ! c c ! c c ! ! c
c c ! c ! ! ! c ! x ! c ! ! c ! c c
c c ! ! ! , ! c ! ! ! ! ! ! c 2 c c
c c ! ! c ! ! ! ! ! c c c c c % c c
c c c c c c c c c c c c c c c c c c
c c c c c c c c c c c c c c c c c c
c c c c c c c c c c c c c c c c c c
c c c c c c c c c c c c c c c c c I
