22 12
i i i i i i i i i i i i i i i i i i i i i i
i i i i i i i i i i i i i i i i i i i i i i
i i i i i i i i i i i i i i i i i i i i i i
i i i i i i i i i i ! ! ! ! w i i i i i i i
i i i i % ! . 5 ! 4 ! ! ! ! ! i i i i i i i
i i i i i i i i i i i ! ! ! 5 i i i i i i i
i i i i i i i i i i i ! ! 4 ! i i i i i i i
i i i i i i i i i i i ! ! ! ! i i i i i i i
i i i i i i i i i i i i i i i i i i i i i i
i i i i i i i i i i i i i i i i i i i i i i
i i i i i i i i i i i i i i i i i i i i i i
i i i i i i i i i i i i i i i i i i i i i i

i i i i i i i i i i i i i i i i i i i i i i
i i i i i i i i i i i i i i i i i i i i i i
i i i i i i i i i i i i i i i i i i i i i i
i i i i i i i i i i ! ! ! ! w i i i i i i i
i i i i % ! . 5 ! 4 ! ! ! ! ! i i i i i i i
i i i i i i i i i i i ! ! ! 5 i i i i i i i
i i i i i i i i i i i ! ! 4 ! i i i i i i i
i i i i i i i i i i i ! ! ! ! i i i i i i i
i i i i i i i i i i i i i i i i i i i i i i
i i i i i i i i i i i i i i i i i i i i i i
i i i i i i i i i i i i i i i i i i i i i i
i i i i i i i i i i i i i i i i i i i i i i