22 12
R R R R R R R R R R R R R R R R R R R R R R
R R G R H R J R R R R R G R R R R R H R R R
R R R R R R R R I R R R R R R R R H R R G R
R R R R R R R R R R ! ! ! ! ` R R R I R R R
R R H R % ! - 5 ! 4 ! 3 ! ! ! R R R R R R R
R R R R R R R R R R R ! ! ! 5 R I R F R R R
R R R R R H R R R R R ! ! 4 ! R R R R R R R
R R F R R R R # F R R ! ! ! ! R R R R R R R
R R R G R R R R R # R R R R H R R R R J R R
R R R R R R R R R R R R R R R R F R R R R R
R R F R R R R J R R R G R R R R R R H R R R
R R R R G R R R R R R R R R F R R R R R I R

R R R R R R R R R R R R R R R R R R R R R R
R R R R R R R R R R R R R R R R R R R R R R
R R R R R R R R R R R R R R R R R R R R R R
R R R R R R R R R R x ! u ! ` R R R R R R R
R R R R % ! s 5 t 4 ! 3 ! y ! R R R R R R R
R R R R R R R R R R R ! w ! 5 R R R R R R R
R R R R R R R R R R R ! ! 4 ! R R R R R R R
R R R R R R R R R R R z ! ! ! R R R R R R R
R R R R R R R R R R R R R R R R R R R R R R
R R R R R R R R R R R R R R R R R R R R R R
R R R R R R R R R R R R R R R R R R R R R R
R R R R R R R R R R R R R R R R R R R R R R