18 10
O M O I a a a O M K a a a a a a C O
K a O a a i a O a B O N N N N O M M
I a O a a j a O a a O n a a a O a a
a a O a a a a C N N K a a a a O a a
a a C O H a A I a a B J a D a O a a
a a B K a a a a a a a a a O a O a C
a a a O a a a F O O O J 0 0 o K O O
K a a C H a a a a a a a a A e E a B
K a a B M O O O O O O O O O H a a a
O H a a a a a a a C O O O O K a a A