18 10
c c c c c c c c c c c ` ` c c c c c
c ` ` ` ` ` ` c ` ` ` ! ! c ` ` ` c
c ! ! ! ! ! ! c ! ! ! ! ! ! ! ! ! c
c ! ! : c c ! c ! ! c c ! c c ! ! c
c c ! c ! ! ! c ! 9 ! c ! ! c ! c c
c c ! ! ! 1 ! c ! ! ! ! ! ! c , c c
c c ! ! c ! ! ! ! ! c c c c c % c c
c c c c c c c c c c c c c c c c c c
c c c c c c c c c c c c c c c c c c
c c c c c c c c c c c c c c c c c c
c c c c c c c c c c c c c c c c c I
