18 10
1 1 1 1 1 1 1 1 1 1 1 1 1 1 1 1 1 1
1 1 1 0 0 0 1 1 1 1 0 0 0 1 1 1 1 1
1 0 0 0 0 0 0 0 1 0 0 0 0 0 0 0 0 1
1 0 0 0 9 0 0 0 0 0 0 0 1 1 0 0 0 1
1 1 0 0 0 0 0 0 1 0 50 0 0 1 0 1 1 1
1 1 1 0 0 0 3 0 1 0 0 0 0 1 4 1 1 1
1 1 1 10 0 1 0 0 0 0 0 0 0 1 2 1 1 1
1 1 1 1 1 1 1 1 1 1 1 1 1 1 1 1 1 1
1 1 1 1 1 1 1 1 1 1 1 1 1 1 1 1 1 1
1 1 1 1 1 1 1 1 1 1 1 1 1 1 1 1 1 1
1 1 1 1 1 1 1 1 1 1 1 1 1 1 1 1 1 1
