22 12
R R R R R R R I R R R R R R R R R R J R R R 
R R R G R R F R R H R R R R F R R R R R I R 
R R R R R R R R R R R R R R R R R R R R R R 
R R R R I R R b ! ! ! ! ! R R R R R H R R R 
R R H R R R R 3 5 ' R ) ! ! R R F R R R J R 
R R R R H R R ! ! % ! ! ` ! R R R R R R R R 
R R R R R R R ! f 4 - ! ! ! R I R R J R R R 
R R I R R R R R ! ! R ! ! R R R R R R R R R 
R R R I R R F R R R G R R R R R R R R R R R 
R R R R R G R R I R R R R R R R F R R R G R 
R R R R J R R R R R R J R R R R R R I R R R 
R R R R R R R R G R R R R F R R H R R R R R 

R R R R R R R R R R R R R R R R R R R R R R 
R R R R R R R R R R R R R R R R R R R R R R 
R R R R R R R R R R R R R R R R R R R R R R 
R R R R R R R b ! ! s ! x R R R R R R R R R 
R R R R R R R 3 5 ' R ) ! ! R R R R R R R R 
R R R R R R R y ! % ! ! ` w R R R R R R R R 
R R R R R R R u f 4 - z ! ! R R R R R R R R 
R R R R R R R R ! ! R ! ! R R R R R R R R R 
R R R R R R R R R R R R R R R R R R R R R R 
R R R R R R R R R R R R R R R R R R R R R R 
R R R R R R R R R R R R R R R R R R R R R R 
R R R R R R R R R R R R R R R R R R R R R R 