22 12
R R R R R R R R R R R R R R R R R R R R R R
R R R R R R R R R R R R R R R R R R R R R R
R R R R R R R R R R R R R R R R R R R R R R
R R R R R R y ! ! ! ! ! R R R R R R R R R R
R R R R R R ! 5 + R 1 ! ! R R R R R R R R R
R R R R R R ! ! % ! ! w ! R R R R R R R R R
R R R R R R ! } 4 . ! ! ! R R R R R R R R R
R R R R R R R ! ! R ! ! R R R R R R R R R R
R R R R R R R R R R R R R R R R R R R R R R
R R R R R R R R R R R R R R R R R R R R R R
R R R R R R R R R R R R R R R R R R R R R R
R R R R R R R R R R R R R R R R R R R R R R

R R R R R R R R R R R R R R R R R R R R R R
R R R R R R R R R R R R R R R R R R R R R R
R R R R R R R R R R R R R R R R R R R R R R
R R R R R R y ! ! ! ! ! R R R R R R R R R R
R R R R R R ! 5 + R 1 ! ! R R R R R R R R R
R R R R R R ! ! % ! ! w ! R R R R R R R R R
R R R R R R ! } 4 . ! ! ! R R R R R R R R R
R R R R R R R ! ! R ! ! R R R R R R R R R R
R R R R R R R R R R R R R R R R R R R R R R
R R R R R R R R R R R R R R R R R R R R R R
R R R R R R R R R R R R R R R R R R R R R R
R R R R R R R R R R R R R R R R R R R R R R