22 12
R R R R R R R R R R R R R R R R R R R R R R
R R R R R R R R R R R R R R R R R R R R R R
R R R R R R R R R R R R R R R R R R R R R R
R R R R R R b ! ! ! ! ! R R R R R R R R R R
R R R R R R 3 5 + R 1 ! ! R R R R R R R R R
R R R R R R ! ! % ! ! ` ! R R R R R R R R R
R R R R R R ! f 4 . ! ! ! R R R R R R R R R
R R R R R R R ! ! R ! ! R R R R R R R R R R
R R R R R R R R R R R R R R R R R R R R R R
R R R R R R R R R R R R R R R R R R R R R R
R R R R R R R R R R R R R R R R R R R R R R
R R R R R R R R R R R R R R R R R R R R R R

R R R R R R R R R R R R R R R R R R R R R R
R R R R R R R R R R R R R R R R R R R R R R
R R R R R R R R R R R R R R R R R R R R R R
R R R R R R b ! ! ! ! ! R R R R R R R R R R
R R R R R R 3 5 + R 1 ! ! R R R R R R R R R
R R R R R R ! ! % ! ! ` ! R R R R R R R R R
R R R R R R ! f 4 . ! ! ! R R R R R R R R R
R R R R R R R ! ! R ! ! R R R R R R R R R R
R R R R R R R R R R R R R R R R R R R R R R
R R R R R R R R R R R R R R R R R R R R R R
R R R R R R R R R R R R R R R R R R R R R R
R R R R R R R R R R R R R R R R R R R R R R