22 12
i i i i i i i i i i i i i i i i i i i i i i
i i i i i i i i i i i i i i i i i i i i i i
i i i i i i i i i i i i i i i i i i i i i i
i i i i i i y ! ! ! ! ! i i i i i i i i i i
i i i i i i ! 5 + i 1 ! ! i i i i i i i i i
i i i i i i ! ! % ! ! w ! i i i i i i i i i
i i i i i i ! } 4 . ! ! ! i i i i i i i i i
i i i i i i i ! ! i ! ! i i i i i i i i i i
i i i i i i i i i i i i i i i i i i i i i i
i i i i i i i i i i i i i i i i i i i i i i
i i i i i i i i i i i i i i i i i i i i i i
i i i i i i i i i i i i i i i i i i i i i i

i i i i i i i i i i i i i i i i i i i i i i
i i i i i i i i i i i i i i i i i i i i i i
i i i i i i i i i i i i i i i i i i i i i i
i i i i i i y ! ! ! ! ! i i i i i i i i i i
i i i i i i ! 5 + i 1 ! ! i i i i i i i i i
i i i i i i ! ! % ! ! w ! i i i i i i i i i
i i i i i i ! } 4 . ! ! ! i i i i i i i i i
i i i i i i i ! ! i ! ! i i i i i i i i i i
i i i i i i i i i i i i i i i i i i i i i i
i i i i i i i i i i i i i i i i i i i i i i
i i i i i i i i i i i i i i i i i i i i i i
i i i i i i i i i i i i i i i i i i i i i i