22 12
S S S S S S S S S S S S S S S S S S S S S S 
S S S S S S S S S S S S S S S S S S S S S S 
S S S S S ! ! ! ! S S S S S % 0 7 ! _ S S S 
S S S S S ! / 7 ! S S S S S S S S ! ! S S S 
S S S S S ! 7 ! ! 7 ! ! 2 ! ! ! ! ! ! S S S 
S S S S S ! S d ! 7 ! ! 7 ! ! ! 7 ( ! S S S 
S S S S S ! S ! , ! ! S S S 7 S ! ! ! S S S 
S S S S S ! S ^ ! ! ! ! ! ! ! S ! ! ! S S S 
S S S S S ! S S S S S S S S 7 S ! ) ! S S S 
S S S S S ! ! ! ! ! ! ! ! ! ! ! ! ! ! S S S 
S S S S S S S S S S S S S S S S S S S S S S 
S S S S S S S S S S S S S S S S S S S S S S  
    
S S S S S S S S S S S S S S S S S S S S S S 
S S S S S S S S S S S S S S S S S S S S S S 
S S S S S ! ! ! ! S S S S S % 0 7 ! _ S S S 
S S S S S ! / 7 ! S S S S S S S S ! ! S S S 
S S S S S ! 7 ! ! 7 ! ! 2 ! ! ! ! ! ! S S S 
S S S S S ! S d ! 7 ! ! 7 ! ! ! 7 ( ! S S S 
S S S S S ! S ! , ! ! S S S 7 S ! ! ! S S S 
S S S S S ! S ^ ! ! ! ! ! ! ! S ! ! ! S S S 
S S S S S ! S S S S S S S S 7 S ! ) ! S S S 
S S S S S ! ! ! ! ! ! ! ! ! ! ! ! ! ! S S S 
S S S S S S S S S S S S S S S S S S S S S S 
S S S S S S S S S S S S S S S S S S S S S S  