19 11
! ! ! ! ! ! ! ! ! ! ! ! ! ! ! ! ! ! !
! ! ! ! ! ! ! ! ! ! ! ! ! ! ! ! ! ! !
! ! ! ! ! ! ! ! ! ! ! ! ! ! ! ! ! ! !
! ! ! ! ! ! ! ! ! ! ! ! ! ! ! ! ! ! !
! ! ! ! ! ! ! ! ! ! ! ! ! ! ! ! ! ! !
! ! ! ! ! ! ! ! ! ! ! ! ! ! ! ! ! ! !
! ! ! ! ! , ! ! ! ! ! ! ! ! ! ! ! ! !
! ! ! ! ! ! ! ! ! ! ! ! ! ! ! ! ! ! !
! ! ! ! ! ! ! ! ! ! ! ! ! ! ! ! ! ! !
! % ! ! ! ! ! ! ! ! ! ! ! ! ! ! ! ! !
! ! ! ! ! ! ! ! ! ! ! ! ! ! ! ! ! ! !

c c c c c c c c c c c c c c c c c c c
c ! ! ! ! ! ! ! ! ! ! ! ! ! ! ! ! ! c
c ! ! ! ! ! ! ! ! ! ! ! ! ! ! ! ! ! c
c ! ! ! ! ! ! ! ! ! ! ! ! ! ! ! ! ! c
c ! ! ! ! ! ! ! ! ! ! ! ! ! ! ! ! ! c
c ! ! ! ! ! ! ! ! ! ! ! ! ! ! ! ! ! c
c ! ! ! ! ! ! ! ! ! ! r ! ! ! ! ! ! c
c ! ! ! ! ! ! ! ! ! ! ! ! ! ! ! ! ! c
c ! ! ! ! ! ! ! ! ! ! ! ! ! ! ! ! ! c
c ! ! ! ! ! ! ! ! ! ! ! ! ! ! ! ! ! c
c c c c c c c c c c c c c c c c c c c