19 11
c c c c c c c c c c c c c c c c c c c
c ! ! ! ! ! ! ! ! ! ! ! ! ! ! ! ! ! c
c ! ! ! ! ! ! ! ! ! ! ! ! ! ! ! ! ! c
c ! ! w ! ! y ! ! x ! ! z ! ! { ! ! c
c ! 7 . ! ! + ! ! 2 ! ! - ! ! / ! ! c
c ! ! ! ! ! 7 ! ! ! ! ! ! ! ! ! ! ! c
c ! ! ! ! } ! ! ! ! ! ! ! | ! ! ! ! c
c ! ! ! ! 1 7 ! ! ! ! ! ! 0 ! ! ! ! c
c ! ! 7 ! ! s ! ! t ! ! u ! ! v ! ! c
c ! ! , ! ! * ! ! ' ! ! ) ! ! ( ! ! c
c % ! ! ! ! ! ! ! ! ! ! ! ! ! ! ! ! c
c c c c c c c c c c c c c c c c c c c