19 11
c c c c c c c c c c c c c c c c c c c
c ! ! ! ! ! ! ! ! ! ! ! ! ! ! ! ! ! c
c ! ! ! ! ! ! ! ! ! ! ! ! ! ! ! ! ! c
c ! ! w ! ! y ! ! x ! ! z ! ! { ! ! c
c ! ! . ! ! + ! ! 2 ! ! - ! ! / ! ! c
c ! ! ! ! ! ! ! ! ! ! ! ! ! ! ! ! ! c
c ! ! ! ! } ! ! ! ! ! ! ! | ! ! ! ! c
c ! ! ! ! 1 ! ! ! ! ! ! ! 0 ! ! ! ! c
c ! ! r ! } s ! ! t ! ! u ! ! v ! ! c
c ! ! , ! ! * ! ! ' ! ! ) ! ! ( ! ! c
c % ! ! ! ! ! ! ! ! ! ! ! ! ! ! ! ! c
c c c c c c c c c c c c c c c c c c c